14 13
26 27 27 27 27 27 27 27 27 27 27 27 28
29 23 23 23 23 23 23 23 23 23 23 23 30
29 24 24 24 24 24 24 24 24 24 24 24 30
29 25 25 25 25 25 25 25 25 25 25 25 30
29 14 15 15 15 15 15 15 15 15 15 16 30
29 17 18 18 18 18 18 18 18 18 18 19 30
29 17 18 18 18 18 18 18 18 18 18 19 30
29 17 18 18 18 18 18 18 18 18 18 19 30
29 17 18 18 18 18 18 18 18 18 18 19 30
29 17 18 18 18 18 18 18 18 18 18 19 30
29 17 18 18 18 18 18 18 18 18 18 19 30
29 20 21 21 18 21 21 21 21 21 21 22 30
31 32 32 34 21 35 32 32 32 32 32 32 33
36 36 36 31 32 33 36 36 36 36 36 36 36